111111111111111111111111111111111111111111111
122222222211112222222211111111111111111111111
12       212    3    211111111111111222222221
12 s     212  11111  2111111111111112      21
1111111  212         2111111111111112      21
1111112  212          22222222222222   12  21
1111112  212   222                     12  21
1111112  21111111111111111111111111111112  21
1111112   222222222222222222222222222222   21
1111112                                    21
111111111111111111111111111111111111111111111