11111111111111111111111111111111111111111111111111
1                                                1
1                                                1
1                                                1
1                                                1
1 222 2   2  222 22  2  222 22222 222 22 2 2222  1
1 2 2 2  2 2  2  2  2 2 2 2 2 2 2  2  22 2 2     1
1 2 2 2  2 2  2  2  2 2 2 2 2 2 2  2  22 2 2     1
1 222 2  222  2  22 2 2 22  2 2 2  2  22 2 2 22  1
1 2   2  2 2  2  2  2 2 2 2 2 2 2  2  2 22 2  2  1
1 2   2  2 2  2  2  2 2 2 2 2 2 2  2  2 22 2  2  1
1 2   22 2 2  2  2   2  2 2 2 2 2 222 2 22 2222  1
1                                                1
1                                                1
1                                                1
1                                                1
11111111111111111111111111111111111111111111111111
1                                               31
1                                            11111
1                        s               111111111
11111111111111111111111111111111111111111111111111
1                                                1
1                                                1
1                 22222 22      22   22222 22 22 1
1                 22 22 22    222222 22222 22 22 1
1                 2222  22    22  22 22    2222  1
1                 2222  22    22  22 22    2222  1
1                 22 22 22222 222222 22222 22 22 1
1                 22222 22222   22   22222 22 22 1
1                                                1
1                               22  22 22222  2  1
1                               2 2 2  2 2 2 2 2 1
1                               2 2 22 2 2 2 2 2 1
1                               2 2 2  2 2 2 2 2 1
1                               22  22 2 2 2  2  1
1                                                1
1                                                1
11111111111111111111111111111111111111111111111111