1111111111111111111111111111111111111111111111111111111111111111111111111111111
1222222222222222222221222212222222222222222222222222122222222222222222222222221
12                  21   21                        212                       21
12  s               21   21                        212                       21
11111111111111111   21   21    111                 212                       21
12222222222222222   21   21    212                 212            1     1    21
12                  211  211   212                 212     1     212   212   21
12                  21   21    212                 212           212   212   21
12                  21   21    212                 212           212   212   21
12                       21    212                 212           212   212   21
12                       21    212                 212           212   212   21
1111111111111111111111   211   212                 212     1     212   212   21
1222222222222222222222   21    212                 212           212   212   21
12                       21    212                 212           212   212   21
12                             212                 212           212   212   21
12                             212                 212           212   212   21
1111111111111111111111111111   212                 212     1     212   212   21
1222222222222222222222222222   212                  2            212   212   21
12                             212                               212   212   21
12                             212                               212   212   21
12                             212                               212   212   21
12                             212                               212   212   21
12                             212                  2            212   212   21
12                             212                 212           212   212   21
12                             212                 212           212   212   21
12222222222222222222222222222222122222222222222222221222222222222212 r 212 3 21
1111111111111111111111111111111111111111111111111111111111111111111111111111111