1111111111111111111111
12                   1
12                   1
12               2   1
12  s           212 31
1111111111111111111111