2222222222222222222222
26                   2
26                   2
26               3   2
26              726 52
2222222222222222222222