11111111111111111111111111111111111111111111111111111111111111
12222212222222222222222222222222222222222221111111111111111111
12   212                                   2111111111111111111
12 s 212                                    211111111111111111
12   212      222                            21111111111111111
12   212     21112                            2111111111111111
12   212     2112                              211111111111111
12   212     21112                              21111111111111
12   212     2112                                2111111111111
12   212     21112  1                             211111111111
12   212     2112                                  21111111111
12   212     21112      2  2  2        2222         2111111111
12   212     21112222222122122122111   1111          211111111
12   212     2111111111111111111112                   21111111
12   21222   212222222222222222222                     2111111
12   211112  21                            1            211111
12   21222   21                                          21111
12   21      21                                 2         2111
12   213     21                                212         211
12   2111111111                  2              2      1    21
12   21                          12                 2       21
12   21     2                    112               212      21
12   21    212     2        2    1112               2       21
12          2     211111111112   11112                      21
12              2  2        2    111112       1             21
12             212               1111112                    21
12   1111111    2                11111112                   21
12   21                          111111112                  21
12   21                          1111111112                 21
12   21                          11111111112                21
12222212222222222222222222222222211111111111222222222222222221
11111111111111111111111111111111111111111111111111111111111111