1111111111111111111111111111111111111111111111111111111111111111111111111111111111111111111111111111111111111111
1111111111111111111111111111111111111111111111111111111111111111111111111111111111111111111111111111111111111111
1                                                                                                       21111111
1  s                                                                                                    21111111
11111111111111111112                                                                                    21111111
12                112                           2    2        2    2        2    2                      21111111
12                1112                         212  212      212  212      212  212                     21111111
12        222   3 11112                        212  212      212  212      212  212                     21111111
12      11111111111111122222                   212  212      212  212      212  212        2      2     21111111
12      2222211111111111111111                 21111112      21111112      21111112       2111111112    21111111
12          212222222222222222                  222222        222222        222222         2      2     21111111
12          212                                                                                         21111111
12          2122222222222222222222222222222222222222222222222222222222222222222222222222222222222212    21111111
11111       2111111111111111111111111111111111111111111111111111111111111111111111111111111111111112    21111111
111112       222222222211111111111111111111111111111111111111111111111111111111111111111111111111112    21111111
111112                 11111111111111111111111111111111111111111111111111111111111111111111111111112    21111111
111112                 11111111111111111111111111111111111111111111111111111111111111111111111111112    21111111
12222                 211111111111111111111111111111111111111111111111111111111111111111111111111112    21111111
12           1       2111111111111111111111111111111111111111111111111111111111111111111111111111112    21111111
12                    211111111111111111111111111111111111111111111111111111111111111111111111111112    21111111
12                     11111111111111111111111111111111111111111111111111111111111111111111111111112    21111111
11111                  12222222222222222222222222222222222222222222222222111111111111111111111111112    21111111
111112                212                                               2111111111111111111111111112     2222221
111112               2112                                               2111111111111111111111111112           1
111112                212                                               2111111111111111111111111112           1
12222                  12                                                222111111111111111111111112           1
12           1         12                                                   211111111111111111111112           1
12                    212                                                    21111111111111111111112           1
12                   21122222222  22222222222  2                              2111111111111111111112           1
11111                 2111111111  11111111111111                                                 21            1
111112                 222222222  22222222222222                         2                       21            1
111112                                                                   1                       21            1
111112                11111111111111111111111111      1              1   1      1111111111111                  1
12222                 22222222222222222222222222                2222212221      2122222222222                  1
12                                                             21111111111      212                            1
122222222222222222222222222222222222222222222222222222222222222111111111112222222122222222222222    222222222221
1111111111111111111111111111111111111111111111111111111111111111111111111111111111111111111111111111111111111111
1111111111111111111111111111111111111111111111111111111111111111111111111111111111111111111111111111111111111111