22222222222222222222222222222222222222222222222222222222222222222222222222222222222222222222222222222
12222222222222222222222222222222222222222222222222222222222111111111111111111111111111111111111111111
12                                                        2111111111111111111111111111111111111111111
12                                                        2111111111111111111111111111111111111111111
12                        2                               2111111111111111111111111111111111111111111
12                       212                              2111111111111111111111111111111111111111111
12         2              2                      2    22  2111111111111111111111111111111111111111111
12        212    1111              11111        212  2112 2111111111111111111111111111111111111111111
12        212                                   212  2112 2111111111111111111111111111111111111111111
12     2  212                                   212  2112 2111111111111111111111111111111111111111111
12    2111112222222222222222222222222222        212  2112 2111111111111111111111111111111111111111111
12    21111111111111122222222222111111112       212  2112 2111111111111111111111111111111111111111111
12     2222222222222222222222222222222212       212  2112 2111111111111111111111111111111111111111111
12  s                                r 12       212  2112 2111111111111111111111111111111111111111111
11111111111111111111111111111111111111112       212  2112 2111111111111111111111111111111111111111111
111111111111111111111111111111111111111122222222212  2112 2111111111111111111111111111111111111111111
111111111111111111111111111111111111111111111111112  2112 2111111111111111111111111111111111111111111
11111111111111111111111111111111111111112            2112 2111111111111111111111111111111111111111111
11111111111111111111111111111111111111112            2112 2111111111111111111111111111111111111111111
11111111111111111111111111111111111111112            2112 2111111111111111111111111111111111111111111
11111111111111111111111111111111111111112            2112 2111111      111111111111111111111111111111
11111111111111111111111111111111111111112            2112 2111111 111  111111111111111111111111111111
11111111111111111111111111111111111111112            2112 2111111 111  111111111111111111111111111111
11111111111111111111111111111111111111112            2112 2111111 111  111111111111111111111111111111
11111111111111111111111111111111111111112       111111112         111  111111111111111111111111111111
11111111111111111111111111111111111111112       222221112         111  111111111111111111111111111111
11111111111111111111111111111111111111112            2112 11111111111  111111111111111111111111111111
11111111111111111111111111111111111111112            2112211111111111  111111111111111111111111111111
11111111111111111111111111111111111111112            2111111111111111  111111111111111111111111111111
11111111111111111111111111111111111111112                 21111111111  111111111111111111111111111111
11111111111111111111111111111111111111112                 21111111111  111111111111111111111111111111
11111111111111111111111111111111111111112                 21111111111  111111111111111111111111111111
11111111111111111111111111111111111111112222222222        21111111111  111111111111111111111111111111
11111111111111111111111111111111111111111111111111        21111111111  111111111111111111111111111111
11111111111111111111111111111111111111112                 21111111111  111111111111111111111111111111
11111111111111111111111111111111111111112                 21111111111  111111111111111111111111111111
11111111111111111111111111111111111111112                 21111111111  111111111111111111111111111111
11111111111111111111111111111111111111112                 21111111111  111111111111111111111111111111
11111111111111111111111111111111111111112                 21111111111  111111111111111111111111111111
11111111111111111111111111111111111111112                 21111111111  111111111111111111111111111111
11111111111111111111111111111111111111112                 21111111111  111111111111111111111111111111
11111111111111111111111111111111111111112                 21111111111  111111111111111111111111111111
11111111111111111111111111111111111111112                 21111111111  111111111111111111111111111111
11111111111111111111111111111111111111112       222222222221111111111  111111111111111111111111111111
11111111111111111111111111111111111111112       111111111111111111111  111111111111111111111111111111
11111111111111111111111111111111111111112                 21111111111  111111111111111111111111111111
11111111111111111111111111111111111111112                 21111111111  111111111111111111111111111111
11111111111111111111111111111111111111112                 21111111111  111111111111111111111111111111
11111111111111111111111111111111111111112                 21111111111  111111111111111111111111111111
11111111111111111111111111111111111111112                 21111111111  111111111111111111111111111111
11111111111111111111111111111111111111112                 21111111111  111111111111111111111111111111
11111111111111111111111111111111111111112                 21111111111  111111111111111111111111111111
11111111111111111111111111111111111111112                 21111111111  111111111111111111111111111111
11111111111111111111111111111111111111112                 21111111111  111111111111111111111111111111
11111111111111111111111111111111111111112                 21111111111  111111111111111111111111111111
11111111111111111111111111111111111111112222222222        21111111111  111111111111111111111111111111
11111111111111111111111111111111111111111111111111        21111111111  111111111111111111111111111111
11111111111111111111111111111111111111112                 21111111111  111111111111111111111111111111
11111111111111111111111111111111111111112                 21111111111  111111111111111111111111111111
11111111111111111111111111111111111111112                 21111111111  111111111111111111111111111111
11111111111111111111111111111111111111112                 21111111111  111111111111111111111111111111
11111111111111111111111111111111111111112                 21111111111  111111111111111111111111111111
11111111111111111111111111111111111111112                 21111111111  111111111111111111111111111111
11111111111111111111111111111111111111112                 21111111111  111111111111111111111111111111
11111111111111111111111111111111111111112                 21111111111  111111111111111111111111111111
11111111111111111111111111111111111111112                 21111111111  111111111111111111111111111111
11111111111111111111111111111111111111112                 21111111111  111111111111111111111111111111
11111111111111111111111111111111111111112                 21111111111  111111111111111111111111111111
11111111111111111111111111111111111111112       222222222221111111111  111111111111111111111111111111
11111111111111111111111111111111111111112       111111111111111111111  111111111111111111111111111111
11111111111111111111111111111111111111112                 21111111111  111111111111111111111111111111
11111111111111111111111111111111111111112                 21111111111  111111111111111111111111111111
11111111111111111111111111111111111111112                 21111111111  111111111111111111111111111111
11111111111111111111111111111111111111112                 21111111111  111111111111111111111111111111
11111111111111111111111111111111111111112                 21111111111  111111111111111111111111111111
111111111111111111111111111111111111111122222222   222222221111111111                               1
111111111111111111111111111111111111111111111111 r 111111111111111111                             3 1
11111111111111111111111111111111111111111111111111111111111111111111111111111111111111111111111111111