11111111111111111111111111111111111111111111111111
10000000000000000000000000000000000000000000000001
10000000000000000000000000000000000000000000000001
10000000000000000000000000000000000000000000000001
10000000000000000000000000000000000000000000000001
10000000000000000000000000000000000000000000000001
10011111111111111111111111111111111111111111111001
10010000000000000000000000000000000000000000001001
10010000000000000000000000000000000000000000001001
10010000000000000000000000000000000000000000001001
10011111111111111111111111111111111111111111111001
10000000000000000000000000000000000000000000000001
10000000000000000000000000000000000000000000000001
10000000000000000000000000000000000000000000000001
10000000000000000000000000000000000000000000000001
10000000000000000000000000000000000000000000000001
10000000000000000000000000000000000000000000000001
10000000000000111111111111111111111100000000000001
100000000000001                    100000000000001
100000000000001          s        3100000000000001
10000000000000111111111111111111111100000000000001
10000000000000000000000000000000000000000000000001
10000000000000000000000000000000000000000000000001
10000000000000000000000000000000000000000000000001
10000000000000000000000000000000000000000000000001
10000000000000000000000000000000000000000000000001
10000000000000000000000000000000000000000000000001
10011111111111111111111111111111111111111111111001
10010000000000000000000000000000000000000000001001
10010000000000000000000000000000000000000000001001
10010000000000000000000000000000000000000000001001
10010000000000000000000000000000000000000000001001
10010000000000000000000000000000000000000000001001
10010000000000000000000000000000000000000000001001
10010000000000000000000000000000000000000000001001
10011111111111111111111111111111111111111111111001
10000000000000000000000000000000000000000000000001
11111111111111111111111111111111111111111111111111