22222222222222222222222222222222222222222222222222
20000000000000000000000000000000000000000000000002
20000000000000000000000000000000000000000000000002
20000000000000000000000000000000000000000000000002
20000000000000000000000000000000000000000000000002
20000000000000000000000000000000000000000000000002
20022222222222222222222222222222222222222222222002
20028888888888888888888888888888888888888888882002
20028888888888888888888888888888888888888888882002
20028888888888888888888888888888888888888888882002
20022222222222222222222222222222222222222222222002
20000000000000000000000000000000000000000000000002
20000000000000000000000000000000000000000000000002
20000000000000000000000000000000000000000000000002
20000000000000000000000000000000000000000000000002
20000000000000000000000000000000000000000000000002
20000000000000000000000000000000000000000000000002
20000000000000222222222222222222222200000000000002
200000000000002                    200000000000002
200000000000002                   5200000000000002
20000000000000222222222222222222222200000000000002
20000000000000000000000000000000000000000000000002
20000000000000000000000000000000000000000000000002
20000000000000000000000000000000000000000000000002
20000000000000000000000000000000000000000000000002
20000000000000000000000000000000000000000000000002
20000000000000000000000000000000000000000000000002
20022222222222222222222222222222222222222222222002
20028888888888888888888888888888888888888888882002
20028888888888888888888888888888888888888888882002
20028888888888888888888888888888888888888888882002
20028888888888888888888888888888888888888888882002
20028888888888888888888888888888888888888888882002
20028888888888888888888888888888888888888888882002
20028888888888888888888888888888888888888888882002
20022222222222222222222222222222222222222222222002
20000000000000000000000000000000000000000000000002
22222222222222222222222222222222222222222222222222